1111111111111111111111
1E00000000000000000001
1000101001000001010001
1010010001010100010001
10000000P0000000000001
1000000000000000000001
1111111111111111111111