1111111
1E10001
1110C01
1000001
1000P01
1111111