1111111
1E00001
100P001
1000001
1001111
1001C11
1001111
1000001
1111111