1111111111
1E00000001
100000P001
1000000001
1000111001
1C001C1001
1000111001
1111111111