1111111111111111111111
1E0C00C0000C0000000001
1000101001000001010001
1010010001010100010001
1000000000000000000001
1000000P000000000000011
1111111111111111111111