1111111111111111111111
1E000000000000C0000001
1000101001000001010001
1010010001010100010001
1000000000000000000001
1000000000000000000001
1111111111111111111111